                    
 #     P            
 ##    ###          
 #  # ###  ###      
 ####       ###   # 
  #######    ### ## 
    #####           
                   